Lemens J. van	Veuve Lemens
Silvy Sani	סני סילבי
Ettore Colla	קולה אטורה
Bouman Johanna Laura	Kruijder-Bouman Jo
박수근	Pak Su-gŭn
石川 義	Ishikawa Tadashi
Suss Dr.	דר' סוס
Reuven Gross	גרוס ראובן
אלורה ג'ניפר	Allora Jennifer
Piccini Elisabetta	Suor I. P.
אלקלעי שי	Alkalay Shay
Laberador	Juan Fernández
שאול נעמי	Shaul Naomi
Visconti Tedaldo	Gregorius PP. X beato
Arnold Newman	ניומן ארנולד
Newman Abner	ניומן ארנולד
בונוורדי מרצ'לו	Marcelo Bonevardi
Seijiro	Yoshihiko Yoshida
מלרמה סטפן	Mallarme Steph.
Mitello	Agostino
Pseudo-Bede	Venerabilis Baede
Anglicus Beda	Pseudo-Bede
Eliahu Dallal	דלל אליהו
Bach Yehudith	בך יהודית
Guardolino	Carlo Natali
Grey Squirrel	Patrick Swazo Hinds
Giusto Da Guanto	Joos van Wassenhove
Laor Marc	לאור מרק
Doyle Chris	To Ho Fung
בסקין מוריס	Maurice Baskine
大智 勝観	Ochi Shokan
Haggebher Philaleethees	Everardo van der Hooght
Schendel Mira	Dubb Myrrha Dagmar
飯塚 琅玕齋	Yanosuke
歐陽應霽	Yeung Craig Au
Etty Ginat	גינת אתי
Gassel	Lucas van Hellmont
Li Hsi	Wan-ching-lao-jen
Li Xi	Wan-ching-lao-jen
北村 哲郎	Kitamura Tetsuro
כפרי עזרא	Ezra Kafri
Ventura Di Moro	Baldese Pseudo Ambrogio di
Mori Ventura	Baldese Pseudo Ambrogio di
陈树人	Shuren Chen
בטוני פומפיאו גירולמו	Pompeio Batoni
Zonszain Faiga	זונשיין פייגה
אפרתי יעל	Efrati Yael
杉原 信彦	Nobuhiko Sugihara
Duller Yolande C.M.	Wijngaard Yolanda Carla Marijke van de
Kimura Heizō	Mitsuyori
D + S	Elizabeth Diller and Ricardo Scofidio
Johannes-Meister	Master of the Aachener Schrankturen
建畠 覚造	Kakuzo Tatehata
狩野 探道	Morihisa
菊池 一雄	Kikuchi Kazuo
Muto da Ficarolo	Ercole Sarti
Lewis J. F.	Spanish Lewis
איתמר אורנה	Itamar Orna
Miller Hanna	מילר חנה
Odescalchi Benedetto	Innocenzo XI Pope
רוזן דנה	Rosen Dana
קופמן ישראל	Kofman Israel
כהן רות	Ruth Cohn
Gerald Nailor	Walking By The River
Kenji Oomori	大森 健二
אבני אהרון	Aharon Avni
אדני אהרון	Adani Aharon
Berg Asaf	ברג אסף
Carlos the Martyr	Bragança Carlos de
Vadesqidab	Ron Hilbert Coy
Igadim	Wendker Wolfgang
A. Carnegie	卡内基安德鲁
Jia Yongzhi	Aili Jia
한정식	Chŏng-sik Han
Abelardo Pedro	אבעלאר
Grondel	De Wit Gaspar
Cockerell Christabel A.	Lady Frampton
להב ורד	Lahav Vered
中村 真	真三郎
L. Kratké	Kratke Charles
Dolphin Group	Atelier Iruka
MacArthur Miss Molly	Anderson Florence
חורש שושי	Horesh Shoshi
Schwabe Kurt	Conrad Pflüger
il Chiaveghino	Andrea Mainardi
סוייר איזק	Isaac Soyer
丸尾 彰三郎	Maruo Shozaburo
Ὁ Πυθαγόρας ὁ Σάμιος	Pitágoras
Matorin Rivka	מטורין רבקה
Hoyeck Youssef	Ḥuwayyik Yūsuf
בונה שמואל	Bone Shmuel
אליעז אורי	Uri Eliaz
אשבאכר הנס	Hans Aeschbacher
Olivetti e c. s. p. a.	Société Olivetti
هويزنجا، يوهان،	Huzinḥah Yohan
Kheĭzinga Ĭ.	هويزنجا، يوهان،
הימן חנה	Heyman Hanna
דוסק אדוארד אדריאן	Dussek Eduard Adrian
eduard adrian dussek	דוסק אדוארד אדריאן
חזק אברהם	Abraham Hasak
קסטלנובו רינה	Castelnuovo Rina
סגלי אברי	Segali Avri
Standish Mrs.	Lily Blatherwick
פרלשטיין פיליפ	Pearlstein Philip
Milshtein Zvi	מילשטיין צבי
Williams Thomas	w.r. timken
南 政善	Minami Masayoshi
מלר + ג'ון פ'	John P.
Ruth Levita	לויטה רות
קריין ברברה	Bachman Barbara Dell
Gary Goldstein	גולדשטיין גרי
גלי יהונתן	Gali Jonathan
Gagakusai	Bunchō
Filotesio Niccolo di	Matrice Cola dalla
חדי שלמה	Hadi Shlomo
שפירא דפנה	Daphna Shapira
Hanitsu Sakai	Noriichi
Eléonore Lingée	Lefebvre Thérèse-Eléanor
מאיר אבי	Mayer Avi
אשנר מוריס	Achener Maurice Victor
ארז דוד	Erez David
גנג רון	Ron Gang
ברסלאו פול	Paul Braslow
Πτολεμαῖος Σωτήρ	Ptolemaios I Soter King of Egypt
Mu Xin	孙牧心
孙仰中	Mu Xin
מרקייביץ' קזימיר דונין	Markiewicz
Mathys Terwesten	Aquila
野田 英夫	Hideo Noda
Tantte	ДАНТЕ АЛИГИЕРИ
שילה חיה	Chaya Shilo
Centre Beaubourg	C.N.A.C.
Bak Ilan	בק אילן
צוריה ענת	Anat Zuria
Armando	Dodeweerd H. D. van
Bartolo Nanni di	Rosso Il
וולך נעמי	Wallach Naomi
קופלי וויליאם	C.P.L.Y.
Cultureel Centrum	Lesser Antilles
Shunshunsai	Kwansho
Hokuba	Kwansho
P. Van Mol Disciple de Rubens	Pietro Mola
בצלאלי שוחט תמי	Tami Bezaleli Shohet
Prasch	Brouse
Bartolomeo Vanzetti	וואנזעטי בארטאלאמעי
Barnicle Bernie	Stephen Mathewson
J. Heda	heda gerrit willem
Gosallves J.	José Gosálvez de Coniedo
hao Xiaolou	Ren Yi
Charles Raggio Greco	גרקו צ'רלס ר'
Nishimura Ryusuke	西村 龍介／竜介
Sara Konforti	קונפורטי שרה
Josef Sudek	סודק יוסף
Flieg Helmut	Haym St̋ifan
Hay'at al-Āthār al-Miṣrīyah	Egyptian Antiquities Organization
吉原 治良	Yoshihara Yiro
Shulamit Tal	טל שולמית
Association of Black Photographers	Autograph (Organization)
Sanz Juan	Juan de Torrecilla
Nitt︠s︡she Fridrikh	ניעטצשע פרידריך וילהלם
Tooker George	טוקר ג'ורג'
קרגליירו מנואל	Cargaleiro Manuel
Cargaleiro Manuel Alves	קרגליירו מנואל
久保田 金僊	吉太郎
Romain	Jean-Baptiste Harou
Liss Tzila	ליס צילה
晝間 弘	Hiruma Hiroshi
Masayoshi	Kishō Tengō
Rozet Meisler	מייזלר רוזט
Lasseron et associés	Olivier Lasseron (Firm)
יורצברג אולה	Hjortzberg Olle
Helholz Menachem	הלהולץ מנחם
Malbarba	Di Bindoccio Cristoforo
Kyongu	Kang Hŭi-an
נורי סוזן	Norrie Susan
Wu Shih-mang	Huangyongyu
Leroux	לארו ז'ול-מארי אוגוסט
Littauer-Hahn Käthe	Kaethe Berl
שמר יפה	Shemer Yaffa
池部 鈞	Hitoshi Ikebe
Shinkuro	Furuyama Muromasa
Castello Giacomo da	Kerckhoven Jacob Van De
M. Gérard élève de M. Bertin	Louis Auguste Gerard
弦屋光渓	Tsuruya Kōkei
Sata Katsu	佐田 勝
Hailstone Vivien Risling	Cutcha
Nadar Jeune	Adrien Alban Tournachon
Macrino D'Alba	Alladio Giangiacomo de
Miyagawa Shunshō	Kirin
Ririn	Miyagawa Shunshō
我妻 碧宇	榮之助
Hekiu Azuma	榮之助
רגב אתי	Etti Regev
Fidus	Höppener Hugo
Naondo Nakamura	中村 直人
Ludwig XIV King of France	Le Roi Soleil
שטרן לב	Lev Stern
אלרואי ניבי	Alroyi Nivi
זולה אמיל	ЗОЛЯ ЭМИЛЬ
Zuo La	זולה אמיל
אורן גלילה	Oren Galila
Folsom Mrs.	Elizabeth A. Folsom
丹下 健三	Tange Kenzo
Elizabeth Queen consort of George VI	Bowes-Lyon Elizabeth Lady
B: V: S:	Monogrammiert B. v. S.
藤井 浩佑	Koichi Fujii
Fujii Kôyû	藤井 浩佑
ליבס מירה	Leibowitz Miriam
Elbe Lily	Einar Mogens Andreas Wegener
Cody Choi	Chʻoe Hyŏn-ju
פיטשון אבי	Avi Pitchon
Rios Hector	Hex
דאגלס סטן	Stan Douglas
Brown Henry Kirke Mrs.	Margaret Lesley Bush-Brown
Monogrammist JJB	J.J.B.
Puachri Ashraf	פואחרי אשרף
Miri Sivan	סיון מירי
Genthe Dr. Arnold	גנת ארנולד
Banfi Belgiojoso Peressuti Rogers	BBPR Architectural Studio
菅沼 金六	Kinroku Suganuma
וקסלר מנחם רון	Menachem Ron Wexler
Kaburaki Kiyokata	鏑木 清方
春山 武松	Takematsu Haruyama
吉田 政次	Yoshida Masaji
権藤 種男	Taneo Gondo
Dalia Asolin	אסולין דליה
Penny Wagner	וגנר פני
Khufu	Cheops King of Egypt
ואנטונגרלו ז'ורז'	Van Tongerloo Georges
G. G.	Scott  Son & Partners
大矢 峻嶺	Oya Shunrei
Orlandin	Del Purgo
Giulio Orlandini	Del Purgo
Linton Violet	Cheater T.J. (Mrs.)
Shlomo Itzkovitch	איצקוביץ שלמה
猪飼 嘯谷	Ukichi
Claude Vignon (pseudonym)	Rouvier Noémie
Cadiot Noémie	Claude Vignon (pseudonym)
Qunyou	Xie Dashen
Permoser Baltzar	Baldassare Fiammingo
Nukina Kaioku	Shūseido
שניידר גיטה	Schneider Gita
קוגוף ארנסט	Coghuf Ernst
Pseudo-Grunewald	Simon von Aschaffenburg
Gazit Mordecai	גזית מרדכי
Kreniß Matthäus	Meister der Altöttinger Türen
清太郎	Makino Shiro
Pyrgoteles	Lascaris Giovanni Giorgio
M. Garand	Garand Jean Baptiste
Naqavoy'ma	Fred Kabotie
Day After Day	Fred Kabotie
Claire Adler	אדלר קליר
Johannes Georg Jacobus van Arum	Photografische Inrichting
Documentación y Conservación del Moviemento Moderno	DO.CO.MO.MO.
Tour Solidor	Musée de Cap-Horniers
Zoan Andrea di Manova	Il Guadagnino
Girolamo Bassamo	Signor Geronimo
Jack Bilbo	Hugo Baruch
Käp'n Bilbo	Hugo Baruch
Rosenberg Ben	בען
Kōrin	Tadamichi
Abraham Walkowitz	וואלקאוויטש א.
וואלקאוויטש אברהם	Abraham Walkowitz
וולף קרקואר גרטה	Grete Wolf Krakauer
ארד רועי	Arad Roy
לאו ג'וף	Lowe Geoff
Mourgue Pascal	מורג פסקל
Morris R.A.	Richard Allen Morris
אדלר סיליה	Adler Celia
Kōhachirō	Kusumoto Sekkei
Seidel P.P.H.	Delanjo Marcus
No+12	Nomasdoce arquitectos
Tozan	伊東 陶山〔3代目〕
上海普陀區文化局	Shanghai Putuo Qu wen hua ju
菅 楯彦	Tatehiko Suga
Petersen Edvard Frederik	פטרסון אדוורד פרדריק
Horseman Group	Groupe du Cavalier
ויסהוז חיה	Haya Weisshaus
זרמי יחיאל	Zarmi Yechiel
בסון נעים	Naim Basson
Nairn George (Mrs.)	Campbell Cecilia
Cornelis Wouter Bouter	Hendriks C.
Verschuur C.	Cornelis Wouter Bouter
Navellier & L. Marie	נווייה + ל' מארי
Ala napoleonica	Venice (Italy). Museo civico Correr
Toscani Giovanni Di Francesco	Master of the Griggs Cruxifiction
leon brunin	Meuter Léon de
Mörs Jakob the elder	Mores Monogrammist I. M.
Hans van Dijk	Err Henri (ps.)
William Henry Jackson & Co.	W. H. Jackson Phot. and Pub. Co.
בויסן קיי	Kay Bojesen
So-ky	László Sós
毛利 武彦	Mori Takehiko
Klemens VII. Papst	Medici Giulio de’
Honeysuckle C.	Brown Hattie
Goldman Paul	גולדמן פאול
un P.re Capucino	Fra Semplice da Verona
Pesne Mme J.-B. Joyard	Henriette Pesne
לוגסי פרלה	Perla Lugassy
Cassiodoro	Flavius Magnus
Choisy le Conin	Bayros Franz de
Charles Wickert	Виккерт Кароль
מורו משה	Murro Moshe
Jacques Rigaud	Rigaud neuveu du précédent
Salz Sam	19th & 20th Century French Art Inc
Schmisek Johann	Swischegg
פרי מיכה	Perry Micha
פרלמן יפה	Perlman Yaffa
לוי אילן	Ilan Levi
שאן לי	Li Shan
Chance Mrs. W.	Strachey Julia Charlotte
Elizabeth Craven Baroness Craven	Brandenburgh House
Ḥizḳiyahu	יחזקיהו
גוטליב רוזיטה	Gottlieb Rosita
Johannes Antoni Augustinus Plucks	Pluckx
浜口 陽三	Yozō Hamaguchi
סלואן לויס	Sloane Luis
Maeda Kensetsu Kōgyō Kabushiki Kaisha	Maeda Corporation
Ant Jan van (unidentified)	J.v. Ant
Daniel Fuss	פוס דניאל
A. Kalraad	Calraat Abraham Pietersz. van
Orchan Yitzhak	אורחן יצחק
גראנל אוג'יניו פרננדז	Granell Eugenio Fernández
佐々木 素雲	Soun
הוזאר וילמוס	Vilmos Huszár
Huszar	הוזאר וילמוס
Holting Gustave	Winckelmann
כהן דפנה	Cohen Dafna
אלוני שרגא	Aloni Shraga
ספאנו מיכאל	Spano Michael
Anne Pierce	Pierce Mrs. W.
Beaumont Anne	Pierce Mrs. W.
K. Tonny	טוני קריסטיאנס
Galerije Grada Zagreba	Municipal Art Gallery
Seino Tsune	清野 恒
לאובר מרסלו	Lauber Marcelo
G. Fleinck	Cowaert Flinch eleve de Rimbrand
בראל ענת	Anat Barel
מירוז חיים	Meiroz Chaim
Monogrammist SF	S.F.
S. F.	Monogrammist SF
Амалия фон Сакс-Кобург-Гота	Amalie Princess of Sachsen-Koburg-Gotha
Sachsen-Koburg-Gotha Amalia von	Амалия фон Сакс-Кобург-Гота
Schiavone Michelangelo	Chiozzotto
Topino Mary Dick	Mrs. Britches
Shenbo	Pao Shih-ch'en
היל כריסטין	Christine Hill
Tommaso di Giovanni Cassai	Mazzacio
Arnold von Westphalen	Bestürling
וינטראוב מיכאלה	Weintraub Michaella
Tahaygen	Edensaw Charles
צור מיכה	Micha Zur
Francis of Sales Saint	Bishop of Geneva
長谷川 朝風	Shin'ichi
היפוקראטס	Hippokrátēs
Takahashi Kaishu	高橋 介州
Isamu	高橋 介州
植田 壽蔵	Ueda Juzo
Pier Antonio Palmerini	Crocchia Girolamo
Merimée	Jean-François-Léonor
Nai Maki	芳之助
שחר חנה	Schahar Hanna
בוצמן דבורה	Bochman Dvora
荒井良二	Ryôji Arai
McClean Mrs. Douglas	Hale Kathleen
ובר ברוס	Weber Bruce
Wiegand	Wgd.
A. Neranus	Neer Abraham van der
Kakutei	Gojan
Dōjin	Kakutei
fratello del Sig. Cav.re Maratti	Bernabeo Francioni
Щукин Пётр Иванович	Sjtsjoekin Pjotr Ivanovitsj
רז גדעון	Gideon Raz
דרור רינה	Rina Dror
ברנד ענת	Anat Brandt
小川 千甕	Ogawa Sen'yo
多三郎	Ogawa Sen'yo
Platzers Johann Georg	I.G. Plazer
緒方 亮平	Ryohei Ogata
שבתאי כהן צפירה	Tsfira Shabtay Cohen
伊藤 慶之助	Ito Keinosuke
אסייג מוטי	Moti Assayag
瀧川 太郎	Taro
קארנו מריו	Carreno Mario
קיוה חיים	Kiewe Chaim
מנספלד אל	Alfred Mansfeld
Haksan Ch'anha	Kyongdo
McIntosh - Poris	MPA
SIVIM (Group)	Società Imprenditoriale Sviluppo Iniziative Immobiliari
Hicham Berrada	בראדה הישאם
Yehezkel Ezroni	עזרוני יחזקאל
峯 孝	Mine Takashi
Barnea Daniella	ברנע דניאלה
בן אריה יצחק	Ben Arieh Yitzhak
Holle William	הול ויליאם
Hole Will.	הול ויליאם
Bacchiacca Francesco	Verdi Francesco Ubertini dei
גבהארדט יוהאן אוגוסט	Johann August Gebhardt
Shorr Zvi	שור צבי
רובינשטין רוטמן גרטי	Gretty Rubenstein Rotman
Zhaoyang Yin	尹朝阳
Arouet François-Marie	Voltaire
בייראן לארד	Bayrěn
נתנאל זיוה	Ziva Netanel
V. A. Shreter	Schröter Viktor
Yamaha	ヤマハ株式会社
Steinitz Käthe	Nobody Annette
ויינמן בן-ציון	Weinman Ben-Zion
Manzù Pio	מנצו פיו
שניאור אבי	Schneor Avi
Suzuki Sujaku	Kotaro
Nobuko Sugai	菅井暢子
Pitt-Rivers Augustus	Fox Augustus Henry Lane
טומסי מרסלו	Marcello Tommasi
גליקמן ג'ודי אליס	Judy Ellis Glickman
原 勝四郎	Hara Katsushiro
Master of the Privilegios	Loert Juan
פיבן חנוך	Chanoch Piven
加藤 顕清	Kensei Kato
אונדק רומן	Ondák Roman
Lespinasse Gaby	Gabrielle Depeyre
平城繁雄	Shigeo Yamashita
Ram Bracha	ברכה רם
Mr. Clark	Clark (unidentified)
Tadao Andō	安藤忠雄
Trouve Freddy	טרוב פרדי
藤原佐理	Fujiwara Sari
טרלו רלי	Reli Tarlo
רנרט איציק (יצחק)	Rennert Itzik
高光 一也	Kazuya Takamitsu
Masajiro	坂口政治郎
阪口 一草	坂口政治郎
夏鉴清	Xia Jianqing
Valerii Kokurin	Kokurin V. G.
田中 佐一郎	Tanaka Saichiro
J. W.	Monogrammiert JW
Yasukuni	横地 康国
זלצברגר גבי	Salzberger Gabi
ממבוש איצ'ה	Mambush Itche
Il Dentone	Padovano Zuan da Milano
John White	Messrs. White & Flint
Murray Alcosser	אלקוצר מוריי
נרינסקי שלמה	Narinsky S.
Wimmer A.	וימר א'
זהבי נתן	Zahavi Natan
ויטלס מיכל	Vittels Michal
בירנבוים דבורה	Birnbaum Dvorah
ברוך אבנר	Baruch Avner
רוטנברג מיקה	Mika Rottenberg
Tonico Lemos Aud	למוס אוואד טוניקו
וסנטסוב יורי	Yuri Vasnetsov
וינברג תמירה	Tamira Weinberg
ماهر أسعد بكر	Baker Maher Asaad
Burn-Soo Song	송번수
בן-דוד צדוק	David Zadok Ben
Sami Avnissan	אבניסן סמי
שמי יחיאל	Yehiel Shemi
Caylar	Quella
大河内 夜江	Yako Okochi
בראון כריסטופר	Brown Christopher
זימל גיאורג	Zimmelʹ G.
M. de S. D. R.	Scudéri Madeleine de
Ment	Coelho Marcelo Vaz
小林 徳三郎	Tokusaburo Kobayashi
טור מירי	Toor Mirie
University of Illinois at Chicago. Gallery 400	Gallery Four Hundred
Dagan Geula	דגן גאולה
Bonnard Elève de Vander-Meulen	Robert Bonnart
אסכולת טימור	anonymous Timurid
הובר ארנסט	ernst huber
Kagyūkutsu	Toko Oide
Ajirō	Toko Oide
University of Aachen	R.W.T.H.
Home of the Society of the Cincinnati	Anderson House Museum
לוואנדובסקי טדאוש אנדרזיי	Tadeusz Andrezej Lewandowski
Capitole	Hôtel de Ville
Vysoká Škola Umeleckoprumyslová	Academy of Applied Arts
Mikhaēl VIII Palaiologos	Μιχαήλ Η΄ Παλαιολόγος
Michael VIII Palaeologus Emperor of the East	Μιχαήλ Η΄ Παλαιολόγος
Il Sojaro	Gervasio Gatti
Tetsu Katsuda	勝田 哲
Alkaim Michael	אלקיים מיכאל
Bochdani Jacob	Bugdon
בן יעקב יוחנן	Ben Yaakov Jochanan
伊川 鷹治	Takaji Ikawa
Poppi fiorentino	Francesco Morandini
בונפנטי ארטורו	Arturo Bonfanti
Bonfanti A.	בונפנטי ארטורו
梁樹年	Doucun
田辺 竹雲齋	Tanabe Chikuunsai
מוזס מרגרטה	Moses Margretta
לאוטר פאולוס	Paulus Lauters
中野 桂樹	Keiju Nakano
Rabenau Engel von der	Engel Karl Wilhelm Jakob
רף אורית	Orit Raff
טייכר יקותיאל רולנדה	Rolanda Teicher Yekutiel
Capeski Müller	Sch^D
Capescky Muller	Sch^D
סיקוריוס טמי	Siqueiros Tamayo
פרבר הרברט	Silvers Herbert
Master of the Retable of the Reyes Catolicos	La Cruz Diego de
Pope Sixtus IV	Della Rovere Francesco
板谷 波山	Kshichi
Motohide	Kanō Sōshū
Shinsetsu	Kanō Sōshū
杉浦 非水	Tsutomu
Lin Richard	Shaw Yu
Matsushima Ichiro	松島 一郎
Groper $15Vilyam	גראפער װיליאם
El Hispaleto	Garcia y Garcia Rafael
M.I.C.	Matsuyama International Design Corportion
Chiro Ferij	scolaro di Pietro da Cortona detto Ciro
רוזמן סטנלי	Stanley Roseman
Monogrammist A.E.	a. e. pinx.
今井俊満	Toshimitsu Imaï
Jean-Claude Naigeon	Néjau
רוזן קיי	רוזין גלינה
SGUF (Organization)	Schweizerische Gesellschaft für Ur- und Frühgeschichte
Kahn Max	קאהן מקס
Alfred Brunet-Debaines	ברונה-דבאיין אלפרד-לואי
Ashton Winifred	Clemence Dane
שטיין דרק	Derek Stein
Monocolo Il	Asaro Pietro d'
Pietro d'Asaro	Monocolo Il
千葉 あやの	Chiba Ayano
שלונסקי חנן	Shlonsky Chanan
Il Fantastico	Avanzarano Francesco
עשת מולה	Eshet Mula
Ou-po-weng	Songxuedaoren
高林 和作	Wasaku Takabayashi
טמיר משה	Moshe Tamir
Pseudo-Mostaert	Ysenbrant Adriaen
וייס צפורה	Ziporah Weiss
Peter Hencke	Monogrammist PH
堀江 鍬次郎	Kuwajirō Horie
辻 晉堂	Tsuji Shindo
Shindō Tsuji	辻 晉堂
Giorgio D'Alemagna	Il Tedesco
A-B-C Agency	Aktuelle Bilder Centrale
Izdatelʹstvo	Editions Dablus
Marmocchini Cortesi	Fratellini Giovanna
Young Chic	Murat Bernard Young
אדלר פרידריך	Adler Friedrich
Honorius III	Savelli Cencio
כהן גת רוית	Cohen Gat Ravit
Crespi Luigi	Spagnolo figlio
Tsugiyoshi Doi	土居 次義
וייט סי' בי'	Waite Charles B.
Tims Michael	Bronson A. A.
Yujiro	沼田 一雅
קנלבה ריימונד	Kanelba Raymond
ברכה מירי	Bracha Miri
שביב חנה	Shaviv Chana
Zhang Anzhi	張安治
Anzhi Zhang	張安治
Lev Shimon	לב שמעון
لويس التاسع، ملك فرنسا حكم ١٢٢٦-١٢٧٠ ‎	Louis XI re di Francia
山下 大五郎	Yamashita Taigoro
שפילר אלי	Spieler Eli
Чилійський музей доколумбового мистецтва	Chilean Museum of Pre-Columbian Art
tamayo rufino	טמאיו רופינו
Enrique Zvi Weisz	וייץ צבי אנריקה
Kubota Beisen	Jinkaitōda
Kampaku	Jinkaitōda
Anneken	Costa Pietro
walker	Macbeth R. W.
Benítez Sánchez José	Silent Walker
סיון זיוה	Sivan Ziva
מרקס גרהרד	Gerhard Marcks
פטמן ורה	Vera Pitman
Brownlow North	Winchester Bishop of
brand friedrich	F. A. Brandt
Maître à la Ratière	Monogrammist T N
Master With The Mouse Trap	Monogrammist T N
加藤 金一郎	Kato Kin'ichiro
J.J. Stoffe	Stoffe Jan Jacobsz van der
尾崎 元春	Ozaki Motoharu
Shinji Hori	堀 進二
Hout	Louis Dubois
Freytag-Loringhoaven Baroness Elsa von	Ploetz Else Hildegard
小松 茂美	Komatsu Shigemi
幸太郎	鈴木 貫爾
Shaun Peterson	Qwalsius
הרמתי עתידה	Atida Haramati
王右军	Ō Gishi
Kryger Dan	קריגר דן
K. Ing	Kanjanavanit Smanarat
Grimthorpe of Grimthorpe Baron	Beckett of Denison Edmund
Spyros Vassiliou	Barmpas-Spyros
וייט ג'ורג'	George White
תומא חיה	Touma Khaya
Bacler D'Albe Louis Albert Guillain De	M. Baclère d'Albe
אשר מוריס קורנליס	M. C. Escher
Stoffade	Kampen Joos van
אורינג גין	Ohring Jean
Gregory XIV Pope	Sfondrati Nicolaus
Gregor XIV Papst	Sfondrati Nicolaus
מדלי אן	Medalie Ann
ברגר דניאל	Daniel Berger
Taringa-kuri	Kaeaea
Brand Shmuel	ברנד שמואל
Aitken William Maxwell Sir	the Rt Hon Lord Beaverbrook
הלפרן אלחנן	Elhanan Halpern
Senga Hata	Kanō Heishirō
ho Chiujae	myŏng Sudae
Double Shields	Pepion Victor
Krajské muzeum východních Čech v Hradec Králové	Museum Reginaehradecensis
Carolus (1929)	Diederich Carolus
Sperandio Johann	Coleto Giovanni Battista
שמואלי ישראל	Shmueli Yisrael
菊池 隆志	Kikuchi Takashi
Yūsai	Rokusaburō
il Smicca	Giannicola Di Paolo
Manni Giannicola di Paolo	il Smicca
Cutapius	John L. Clarke
三田 康	Yasushi Santa／Sanda
לוריא אסתר	Shapiro Esther Lurie
g. berger	Berger Jacques (1754-1822)
Dady A.R.	William St Alban Rae Dady
Леонилла Ивановна Барятинская	Sayn-Wittgenstein-Berleburg Léonille Bariatinski
רוג'ר סוזן	Suzanne Roger
שניידר אורית	Schnaider Orit
Shavi Orly	שבי אורלי
川崎 小虎	Kawasaki Shoko
Slater Phyllis	Phyllis Murphy
Ovadia Alkara	אלקרה עובדיה
סקרבנסקי ויקטור	Skrebneski Victor
Antischmitz	Hansen Hans
大島 辰雄	Oshima Tatsuo
Hsiao-hsiao	Wen Tong
Hu-chun	Hsiao-hsiao
אנדריה ז'קלין	Andrya Jacqueline
Caroline Queen consort of George IV King of Great Britain	Princess of Wales
פנחסי משה	Moshe Pinhassi
פנסון בוריס	Boris Penson
פירחי ליננברג ורד	Vered Pirhi Linenberg
Master of the Saint Gregory	Collen Johan van
Le vieux Rysbrack	Rijsbregts
飯島 敏三	Toshizo Iijima
Nowy Gmach	New Building
גולבהר פארידה	Golbahar Faride
Gyokujundō	Seishūken
International Association of Art Critics. Greek Section	AICA Hellas
Avissar Simon	אבישר שמעון
Vincenzo Agnetti	אנייטי וינצ׳נצו
סולומון רוזלינד	Solomon Rosalind
גלוטמן יהושע (שוקה)	Glọtman Shuḳa
קצב עוזי	Uzi Katzav
Grant Emily	St. Auby Tamás
Taub Tamas	Grant Emily
וידר שניידר שרה	Sara Wieder Schneider
Spinoza Baruch	שפינאזא ברוך
David Ricard	Rykars
Oakerhater David Pendleton	Making Medicine
Сергеевич Петров-Водкин Кузьма	Kuzma Sergeevich Petrov-Vodkin
Scheffer Tamir	שפר תמיר
Szolnoki Galéria	Art Gallery
Gekko	Rojinsai
Vermejo	Cárdenas Bartolomé de
藤島 茂	Fujishima Shigeru
Maria Zeiller	Uchatius Maria von
Lea Sheves	שבס לאה
Verspronck Jan Cornelisz.	G. Sprong
Struck Hermann	שטרוק הרמן
J. Baptiste Dossi	Battista di Niccolì di Luteri
Baron Harry	ברון הרי
Sawa Hiraki	さわ ひらき
陆俨少	Lu Tongzu
לבנת צביקה	Livnat Zvika
Arie Kotler	קוטלר אריה
Follett Mrs. J. R.	Cathleen Sabine Mann
יעקב ברנר חיה	Jakob Brenner Haya
יפה ניצה	Nitza Yaffe
רייכנבך סילביה	Reichenbach Sylvia
Wellens Jan	Cock Jan De
Weiler Max	Vittorio Mazzucconi
清聖祖	Qing Kangxi Emperor of China
Bharata Itihasa Samshodhaka Mandala	Centre for Indian Cultural Studies
מטוסביץ מיכאל	Matusevitch Michael
Nicolas Bernard Lepeié	M. Lepicié
TSA Architects	Thurlow Small Atelier
Akiva Boker	בוקר עקיבא
Rijck	Ryck Pieter Cornelisz. van
Comte de Lautréamont	Ducasse Isidore
Jarmund/Vignaes AS Architects	JVA (Firm)
山形浩生	ヤマガタヒロ
הנלה פריץ	Fritz Henle
佐和 隆研	Takaaki
טל-קוט פייר	Coat Pierre Tal
Tal-Coat Pierre Jacob	טל-קוט פייר
Noble	Wichita Bill
רבינוביץ גרגור	Rabinovitch Gregor
Edith Kane Baker	Mrs. George F. Baker Jr.
Yang Hsing-wu	Linsulaoren
江本 義理	Yoshimichi Emoto
ביירדן רומר	Bearden Romy
Société française des architectes	S.F.A.
西村 房蔵	Nishimura Fusazo
שטיינוביץ זמי	Steynovitz Zamy
בר יעקב אברהם	Abraham Bar Jacob
Juzan	Kazuhisa
Hambei	Kazuhisa
Barrett Mrs. W. K. T.	Sherlock A. Marjorie
Sherlock Marjorie	Barrett Mrs. W. K. T.
Mulinaretto	piane giov. maria dalle
Österreichische Galerie (1995- )	Belvedere Vienna
wohl Arbeit der Trogerwerkstatt	Troger Simon
Hergé (ps.)	Georges Remy
中島 清之	Kiyoshi
安藤 更生	Kosei Ando
Joste (1438)	Meister Joest
Cremasca	Perola Giovanni Battista
מאהו קורנליס	C.O. MAHV
大森 啓助	Keisuke Omori
ארמינגטון פרנק	Frank Armington
קרייר אוז'ן	Carrière Eugène Anatole
真野 満	Mano Mitsuru
Master of the Crossed Staffs	Hans Wechtlin
Loes van Waalwijk van Doorn	Goedewaagen Louise
Chen Shouyi	陳壽彜
שרון אסתר	Sharon Esther
פלדה הנס	Hans Pallada
Aguado Alejandro María	Marqués de Las Marismas del Guadalquivir
Locatelly Giovanni Francesco	J.-F. Lucatelli
Ovadia Shmuel	עובדיה שמואל
פימה קורין	Corinne Fima
Shigeru Morita	森田 茂
里中 英人	Satonaka Hideto
Καράς Χριστος	Karas Christos
Jorisz. Jan	Brugge Johannes von
Eva Siao	Ye Hua W.-G
Wen-ke	Dongshan
גיסקין גוון	Giskin Gwen
במברגר פריץ	ferdinand bamberger
Joanna of Evreux Queen of France	John Barnard
ארדט הנס רודי	Erdt Hans Rudi
Cwiczeck Mathias	Schwezge
Ky ōu Hoashi	Chidai
Louis 9世 フランス国王	Louis s. IX re di Francia
Ludovik IX King of France	Louis 9世 フランス国王
Franç. de Balko	Palcko
גרוס אגנס	Agnes Gross
איילון עזריאל	Ayalon Azriel
וייג'י (ארתור ה' פליג)	Fellig Usher
Зауервейд Александр Иванович	Zauerveyd Aleksandr Ivanovich
ho Hyuhyudang	Yi Kye-ho
Cock Monogrammist P. V. A.	Coecxe Pieter II
קראוס יוהן אולריך	Kraus Johann Ulrich
Simmons Charles	סימונס צ'רלס
Jan Frans Jozef Mertens	Martin
Lewizkij Dimitrij Grigorjewitsch	Levitscoy
הייד סקוט	Hyde Scott Frederick
אשרוב אלי	Asherov Eli
Deya	Mikumo Shonosuke
Ruud Janssen	T. A. M.
לי רו צונג	Meichi
Maurice-Henry	אנרי מוריס
鬼頭 鍋三郎	Nabesaburo Kito
Yehoshua Zamir	זמיר יהושע
בנרד דרבי	Bannard Darby
Walter Darby Bannard	בנרד דרבי
Weyts (II) Pouwels	Stock Pieter Willemsz. van der
בן חיים אמנון (זיגי)	Ben Haim Amnon
National Portrait Gallery	Smithsonian Institution
אורקין רות	Orkin Ruth
Koshun Kawazu	河津 光浚
הראל גיתית	Harel Gitit
Dr. Atl	Gerardo Murillo
Takachiyo Uemura	植村 鷹千代
ריכטר מירה	Richter Myra
לורי פיטר דה	Lory Peter de
קלדרון אשר	Asher Kalderon
Odol'skij	Grigori Nikolaevich Adolski
Löchelt Elisabeth Beate	הולבק ביאטה
קרטצ'מר ברנהרד	Bernhard Kretzschmar
Newdigate prizeman	W. H. Mallock
Mrs. John Browning	Jackson Harriet A.E.
סרי דוד	David Serry
Ruelle Jean	La Ferte
Waisler Lee	וייסלר לי
תומאס עליזה	Alliza Thomas
Jean Joseph Smits	Schimt
לוסקי דעואל חיים	Aim Luski Duelle
Calamatta	Rochette Josephine
井上 安男	Inoue Yasuo
אפשטיין יעקב	Epstein Jacob Sir
Spode Works	Copeland factory
Xizhe	祝枝山
גרשון שלמה	Gershon Shlomo
f. x. pieler	Petter Franz Xaver
島野 三秋	Shintaro
Grammatica	Antivédutus
Errell	Levy Richard
Neysa Moran Mc Mein	Baragwanath John G. Mrs.
地主 悌助	Jinushi Teisuke
פרלמן יצחק	Perlman Itzchak
山鹿 清華	Seika Yamaga
H. Stoccade Nicolaes van	Helt Stockade
Eisenhardt Johannes Caspar	אייזנהרדט יוהנס קספר
Johann Siberechts	Cibrack
Simay Francois	Francesco Franceschini
Salome	Σαλώμη
Sabbioneta	Vincenzo Pisenti
Tabboo!	Stephen Tashjian
Rayah Redlich	רדליך רעיה
חודורובסקי ליפקינד אנה	Anna Khodorovsky Lipkind
王璜生	Wang Huang-sheng
אשל גרשוני ביאנקה	Eshel Gershuni Bianca
בסנטא קרלוס	Carlos Basanta
קאר אידה	Kar Ida
BKB Architects	Boyce Kemp & Bron
Eacout	G. v.d. Eekhout
שוובל איבן	Shṿebel Iṿan
שוובל איוון	Shṿebel Iṿan
Hammelmik	Memmelynghe Jan van
硲 伊之助	Hazama Inosuke
אייל אבישי	Ayal Avishay
עובדיה עדה	Ada Ovadia
Jiliang Hou	侯吉谅
מרדכוביץ חוה	Hava Mardcovitz
מורנו פנקס	Pincas Moreno
China) Hong fa si (Shenzhen Shi	弘法寺 (深圳市中国)
Michiel van Arenborgh	Eerdenberch ...
Tameushi Igyū	Kiminobu
Colin Self	סלף קולין
Yoshio Mitsui	三井 義夫
Λυδάκης Στέλιος	Lydakis Stylianos
קרפין ג'וזף	Crepin Joseph
SADAS	PEA
עבאדי שי	Shay Abadi
Charles d’Orléans	Rogers Richard
Geh Rath Haes	Haes von (Bonn)
Aisenshtat Alexander	Айзенштат Александр
נרקיס מרדכי	Narkis Mordecai
Yarden Piri	ירדן פירי
鬼原 素俊	Kumazo
בן שלום נעה	Noa Ben Shalom
אלחסיד נגה	Alhassid Noga
Adi Sened	סנד עדי
Vinciata	King Joseph Wallace
Taikyoan	Kōetsu Hon'ami
Lian Ju	Luofu sanren
רול יעל	Roll Yael
Schlusberg Hannah	שלוסברג חנה
יונסקו אירינה	Ionesco Irèna
Irina Ionesco	יונסקו אירינה
H. O.	Ellis & Clarke
Meira Rapaport	רפופורט מאירה
Gelder Claes	N.V. Gölder
בן עדי ניב	Niv Ben Adi
Sfrisato Francesco	Il Legnago
Teys	Thijs Pieter Joseph
宮本隆司	Ryūji Miyamoto
סינגייר גוסטב	Singier Gustave
Klint Tage	קלינט טאג
B.O.M.A. International	Building Owners and Managers Association International
Worsley Mrs. Leila	Faithfull Leila
Moscowitz Amalia	Lesznai Anna
Ronald Feldman Fine Arts Inc.	Feldman Gallery
Giol Draper Pere	Pierre Adrien Graillon
Duenwege Heinrich	Boghert Derick
Gérard Louis-Auguste	M. Gérard élève de M. Bertin
Cäsar Robertus a Biturgia	Cesare di Civitella
Namch'ang	Kim Hyon-song
Rumney Mrs. Pegeen	Vail Pegeen
Plonski	Michał Płoński
Master Of Gustrow	Meester van het Altaar te Güstrow
Calis Ineke	Kuipers Ineke (1946)
Ackermann Gallery	arthur ackerman & son Ltd
M. Deseve	Sève
Town Museum	Mestské Muzeum
Eglise de Sainte-Walburga Antwerpen	St. Walburga's Church
Steel Miss Mary	Armour Mary
Frederick the Peaceful	Friedrich III King of Germany
Miss Reed	Katherine Read
Kisai	Rissho
M. du Rameau	Louis Jean Jacques Durameau
University of Lugano	USI (Università della Svizzera italiana)
Thirty-one Studio	31 Studio
Camfort	[Craufurd]
Leclerc Jean (1717-1768)	Clerc Johann Friedrich
mcclees galleries	j.e. mcClees & co Inc
Konody Mrs. Paul G.	Pyke-Nott Miss Isabel Codrington
Mayer Mrs. Gustave	Konody Mrs. Paul G.
konstantin stoitzner	stoitzner c.
John VI	Giovanni VI papa
Mackay Patty	Aberigh-Mackay Miss
Monjoky	Mányoki Adám
Nijmegen Elias Van	Nymwegen
Rutherston Mrs. Charles L.	Elmslie Essil R.
Etude Gros-Delettrez	H. Gros G. Delettrez (Firm)
U-Fan Lee	U-hwan Yi
Shih Tʻao	Chʻing-hsiang-i-jen
J Marsen	J.M. de Jong
Caula Tito	Capurro Francisco José Caula
Tsa-Sha-Wee-Eh	Bragshaw Helen
Monory Jacques	Monori Z︠H︡ak
Lingée Eléonore	Lefebvre Thérèse-Eléanor
Garstens A. J.	Asmus Carstens
Bresciano il (1555/1565)	Prospero Antichi
hao Chanyue	Guan Hsiu
Meister des Heiligen Nikolaus	Master of St. Nicholas
Torrecilla Juan de	Sanz Juan
Comer Alexander	Comer H.
Haritsu Ukwanshi	Muchuan
Robert Eigenberger	Reigen Karl
מוסיי מ' (?)	Mossei M. (?)
Gilbert-Hughes Kate Elizabeth	Gilbert Mrs. Humprey Hughes
Reesbroeck	Reesbroucq Jacobus van
Cheater Violet	Cheater T.J. (Mrs.)
B.H. Thier	Van Thier
Schut de Francfort	Schütze
Bhikṭoriẏā	Victoria Queen
Carlos I King of Spain	Charles V Holy Roman Emperor
Couasky Alexander	Koasqui Polonois
Maius Joannes	Maggi Giovanni
John D. Milner	Riley John
Broome A. N.	Brown Hattie
Rouse (Gent)	Roosa
Roos	Rouse (Gent)
El Razzaz Mostafa	ar-Razzāz Muṣṭafā
Fel'ten Yury Matveyevich	Velten Georg Friderick
A. V. Kunzendorf	Anna Gritschker-Kunzendorf
Rutlinger Johannes	Rut J. Van Der
Fedders Jūlijs	Feders Yuly Bogdanovich
Zegna Angelo (1924)	Zegna Anna
Zegna Aldo (1920-2000)	Zegna Anna
Scott George Gilbert Sir	Scott Adrian
Morven	Jacob Cyprien-Max
De Koninck	Salomon Coninck
Heckel Anton	Huckel
Westinghouse デンキ ガイシャ	Westinghouse Electric
Pluijm Carel van der	Pluym
c. f. deiker fec.	Deiker Karl Friedrich
Dewton Lil	Bing Lilly Mary
Gotsch F. K.	Gotsch Friedrich-Karl
Andrea di Niccolò da Durazzo	Alesi Andrija
Clotaire III re di Neustria e di Borgogna	Hlothar III
Wright Mrs. Edgar P.	Rix Miss Emily Hilda
Michele Fiammingo	Michele de Subleo
Mason William i	Mason Rev.
Vigers A. F.	Vierpeyl Jan Carel
Lord Huntingfield	Sir Joshua Vanneck
Cleve Cornelis van der Beke van	Cleef Sotte-Cleef
Godinho Manuel da Silva	Godo.
Silva Godinho Manuel da	Godo.
Hrvatski restauratorski zavod	Croatian Conservation Institute
Lanfant de Metz	Lanfant Francois Louis
Brendl J.G.	Pendel Jan Jiří
Dighton Phoebe	Earl Phoebe
Gibson Sir	Gibson Donald
Master Of The Frankfurt S. John Altarpiece	Meester der Johannesmartelingen
Cambiaso	Orazio
Haworth Miss	Haworth E. F.
Iosif Chaykov	Y. Ṭshayḳoṿ
Scrope Barnard	B Morland
Yūshidō	Tōshien
Scarpagnino Antonio	Antonio di Pietro Abbondi
nic. bern. lepicie	M. Lepicié
Friedrich Weitsch	Fr. G. Weitsch
Marcus Antonius Gordianus Sempronianus Romanus	Gordian I. Römisches Reich Kaiser
National Library of Naples	Biblioteca nazionale Vittorio Emanuele III
Ainsley D.	Nansen H.
Ths. Agnew & Sons London	Thomas Agnew
Oy Alko Ab	State Alcohol Monopoly
Meester van de Schottenkerk van Wenen	Master of the Schotten Altar II
Fiorentino	Bettini
Bonaparte Joséphine	Josephine Empress of the French
Sibrexe	Cibrack
Stroechling	Straely Eduard
Bichkoff Erik	Byčkov Israel
Vieil Pierre Le	V. M. Le
Le V. M.	Vieil Pierre Le
jutz karl	Iutz
Hondius Hendrick (I)	Heyn de Hont
Cav. r Vanini	Vannini Ottavio
Tabgatch dynasty	Pei Wei dynasty
Reuter Kilian	Mellrichstadt Kilian von
Winghen Jodocus	van Wingen
Paliez	C. Paillet
Kuipens	Kuypers D.
Skif (ps.)	Petrov A. (ps.)
Baikov T.	Bajkov Fedor Il'ič
Menzocchi Francesco	il Vecchio di San Bernardo
Mr. Knyff	Knijff Leendert
Mr. Knife	Knijff Leendert
Hofoper	Staatsoper
Sutter Jules	David Sutter
Ventom & Sons	Mr. Ventom
Brandt der Ältere	Brand Christian Hülfgott
Guérard Johann Joseph Eugen von	e. v. guerard
Trautmann den ältern	I.G. Trautmann
Il Cecco Bravo	Francesco Montilatici
Georg Ludwig Eckhardt	M. Ekart
Lin Shaw Yu	Lin Richard
Cambon Armand	Henri Joseph Armand
Ghaall	Pieter Gaal
Grégoire IV pape	Gregorius
k. ruthart	Rutter
Roma Italia. Palazzo Borghese	Borghese Prince
Krakauėr Z.	Siegfried Kracauer
professor jakobus leisten	i. leisten
de Bock	v. Pock
Lelienbergh Cornelis	J. Van Lelinberg
Marx Suzanne	Suzy Lake
Lévy Isaac	Lévy Georges
Harry Elsas	Elsas Heinz Hugo Erich
Gallet	Galais
Bindol Ben	Pollak Benedikt Fred
Cruysbergen Gysbert	Cruijsborgh P.
Corcoran Gallery	Corcoran Museum of Art
Escuela Técnica Superior de Arquitectura de Sevilla	School of Architecture Sevilla
Firma Katz	d. katz
Dal Friso	Alvise Benfatto
uhde f.c.	Uhde Fritz von
Mensing & Zoon	Mensing&Fils
Rijck Willem de	Deryck
Ryck Willem	Deryck
Breton Virginie Elodie	mm. demont breton
C. V. Bemmel	Georg Christoph Gottlieb von Bemmel the Elder
Hans Keynooghe	Kaynat Jan
P. C. la Fargue	Farque
V. den Eckhout	Eacout
S. Managio	menajgo
Vincent Malò	Malo
Forbes Malcolm	Forbes Steve
Geshan-laoren	Luofu sanren
Formanteij Hendrik de	H. Dromantion
oscar graf krockow	o. v. krockow
teddy schempp	Theodore Schempp & Co.
Daniell the Elder William	W. Daniell R. A.
Roux Bartlomé	Cárdenas Bartolomé de
Pittore della Carola	Anodos Painter
Giovanni Battista Regorini	Sergio Gandini
ILA and UD	Universitá a di Urbino. International Laboratory of Architecture and Urban Design
Unvanck	Aenvanck Théodoor
Pío	Fernández Evaristo Antonio Víctor Pelayo del Valle
Bigelow	Brown and Bigelow Company
Chateignon Ernest	Ernesto Belli
Spetz & Holst Arkitekter	S&H
Clark Benton H.	Clark
Downing Thorpe James	DTJ
Visscher Beernt de	Visscher
Redgemorter	Regenmorten Peter van
Sylvester Baur	Livingstone Barney
Gogh	Gogh Vincent Willem van
Cassi Ramelli Antonio	Casamor de Espona Antonio
Halder Christoph	Charles Echard
Olivetti	Olivetti e c. s. p. a.
Almania Armanus de	Arnoult de Niemeg
Patrick Clifford	Patrice Girod
Alexandra Her Royal Highness Princess	Alexandra Caroline Marie Charlotte Louise Julia Queen of the United Kingdom and the British Dominions and Empress of India.
Le Brun J. B. P. (Jean-Baptiste-Pierre)	LeBrun Stk
Philip van Dyke	p^Th^R. van Dyk
Selmoser Josef	Sert Josep Lluis
Bernard Robert Chaet	Catherineau Roger
Burde	Bürde Paul Eduard Maximilian
Geyling Carl (1814)	c. geyling
Reza Aliabadi	rzlbd
Rax	Axelsson Ragnar
Carlo Ceccarini	Aletrino Arnold
Pam	Marc Payot
Monogrammist C.W.	C. W.
alvin von stein	stein a.
Ld Pelham	Pelham Thomas 1st Earl of Chichester
De Weddel	Wedel-Jarlsberg Frederik Anton graf
Axayácatl	Axayaácatl Emperor of Mexico
Cavendish-Bentinck George Augustus Frederick the Hon.	G. A. F. Cavendish-Bentinck
Hamilton Gawen approximately 1697-1737	Hhmilton
Edward Parker Esq	Pkr
Keely Isaac H.	Keely
SAHBA	Southern Arizona Home Builders Association
Association géńerale des conservateurs des collections publiques de France Provence-Alpes-Côte d'Azur	AGCCPF-PACA
Smith of Piccadilly	D Smith
Ifa-Galerie Berlin	Institut für Auslandsbeziehungen. Ifa-Galerie Friedrichstrasse
Ceernigoj Jaroslav	Jaroslav Comak
Historic Restoration Inc.	RTI
Vanecde	Jan Ivan Den Hecke
Ghiozzi Renzo	Zoren
Lesueur J.-F.	Sueur
Alexander-François Loemans	Loemans F.
Loemans Alexander-François	Loemans F.
Design Collaborative	TBC
Boriani Davide	Foggie David
United States. Department of Defense	DOD
Tunstall	Constable Marmaduke Cuthbert
Somer	Jan Van Somer
Society of Independent Artists	SIA
Bigio Il	Bracelli Giovanni Battista
Pseudo-Longinus	Longïnos
Goçalves Nuno	Gvs
La Coer	De Lacour Pierre I
Heise Reinen MacRae & Associates	HRMA
Rosemary d' (lady) Avigdor-Goldsmid	Goldsmid Rosie
Bernt Notke	Master of the Lübeck Saint Gregory Mass
Rhode Island School of Design	RISD
Sattler Christoph	christ. huet
Instituto Nacional de Antropología e Historia	INAH-SEP
B*** J.J. (unidentified)	J.J.B***
W. L.	Monogrammist W.L.
James Baily	James Boyd
New West Land Company	NWLC
h. scheeres	hendrik jan scheeres
Wright of Liverpool	R. Wright
P.B. & A.	PB&A
Gebhard Leberecht von Blücher Fürst (prince) von Wahlstatt	Marschall Vorwärts
Gerlier b. 1826	Gerlier
Mr Desmoulins rue Hauteville no 27	M. A. Desmoulins
Cosmas II	Cosmatus de Petrus Mellini
Castelló Vicente the elder	Boullongne Louis de the elder
TSPC	Tahoe-Sierra Preservation Council
P. Verbrugghen	Verbruggen Gaspar Pedro II
Carlos Coire	Terence Corish
Paton Sir Joseph Noël	paton
Ring	Ludger Tom Ring der Ältere
Hans Drop	Arno Hassler
Rijksdienst voor de Monumentenzorg	Department for the Preservation of Monuments and Historic Buildings Netherlands
Heers Salmhofer Vollmer	hsv
Kuiper Luitsen	Anquetin Louis
Petit-Radel. Loius Charles Francois	M. Radel
International Committee of Architectural Critics	CICA
Le Bel	Antoine Lebel
Lebel Antoine	Le Bel
Eismann Carlo	Isman
Maluda	Maria de Lourdes Ribeiro
felicetto scolaro di Giacinto Brandi	Ottini Felice
K. A. Z.	KAZ
Capponi Lorenzo b. 1733	Capponi L.
Martinez Daniel	Martin Verstappen
Putti	Johannes van de Putte Nicolaasz.
Hughes Good O'Leary & Ryan	HGOR
Striegel Bernardo	Meester van de Hirscher Collectie
Sir J Wright	James Wright 1st Baronet
Saint-Quentin Jacques Philippe Joseph De	St. Quentin
M. Saint Quentin	Saint-Quentin Jacques Philippe Joseph De
Vanni	Vanni Lippo di
Rini Dado	Dado Catharina Gerarda Maria
Magro de Orbe Ignacio	Magro Iñigo
H. C.	Monogrammist H.C.
CCC	United States. Federal Security Agency. Civilian Conservation Corps
Gobbo Il	Solari Cristoforo (il Gobbo)
PNBA Architects	Patty Berkebile Nelson Associates
J. David Ake	Davis Kelly R.
SLUB	Sächsische Staatsbibliothek--Staats- und Universitätsbibliothek Dresden
Old Breughal	Bruegel Pieter (The Elder) and Pieter Brueghel (The Younger)
Breughal	Bruegel Pieter (The Elder) and Pieter Brueghel (The Younger)
Jean Joseph Pottekens-Verhaghen	J. Pottengen
P.V.L.	Monogrammist P. V. L.
J. Villegas	Villegas y Cordero José
Juvigné	Jean-Baptiste-Guillaume de Gevigney
Fábrica de Louça de Sacavém	Sacavém
Valparaíso School	Universidad Católica de Valparaíso. Escuela de Architectura y Diseño
S H Mildmay	Mildmay Henry Paulet St. John‏ ‎
McCoy and Wixon Architects	McCoy & Wixon
Messrs. Hoggart & Phillips	Mr. Hoggart
Van Nes	Johan Dircksz. Nes
LAUSD	Los Angeles Unified School District
Malo	Malo Vincente I
H. Brosamer	Brösamer Hans (ca. 1495-1554)
Forbin-Janson Charles-Théodore-Palaméde-Antoine-Félix marquis de	Count Forbin Janson
Forbin Janson	Forbin-Janson Charles-Théodore-Palaméde-Antoine-Félix marquis de
Johan dan Maler	Johan
Kamphuijssen	Camphuijzen Govert Dircksz.
Haes von (Bonn)	Haes
De Maeyer Louis	LOD
Nicolai IUsupov prince	Yusupov
GDR CNRS OPuS	Centre national de la recherche scientifique (France). Groupement de recherche
H + N + S	HNS
A. L. Thivet	A. C. Cooper
g. wuttke	Carlo Wuttke
Ag.no Metelli	Mitello
Master of the Béguins	Maître aux Béguins
Shuping	Yunshai
Nelson-Atkins Museum of Art	William R. Nelson Trust
Zore Manja	Zaretsky Dan
Alberto G. D'Atri	Atri Monsieur d'
Schmidtmeyer	Smidtmyer & Co
Winter David	David Meshulam
Deserre	Seres
Olivier Zabat	Folfi Zanobi
Statens Museum for Kunst	Dansk kunstmuseum
Carl Camu	Consalvo Carelli
Disque Dee Deane	Greef Jean de
Master of the Legend of St. Dominic	Meister der Dominikus-legende
Wilson John Appleton	Bilson John
Dieter Hauser	Dieta Vieg
Henry J. & George Henry Robins	Mr. George Robins
Vaucher-Crémieux Samuel	Vaucher Jean Marc S.
Amedeo di Francesco	Meo da Caprino
Zinsser Ernst	Buchbinder Menachem (Ernst)
Harwill Mrs.	F. Harwill
Carlos II Rey de España	Charles II King of Spain
Spielaberger	Spillenberger Johann Von
Fortner Georg	c. fortner
Romualdo Moscioni	Musconi R.
Ly Fauconberg	Countess Fauconberg
Fannie Pete	Ølsted Peter Ivar Johannes
AV 62	AV62
Gelderen Judy van	Geeraerts Jan
Rigaud Dessinateur & Graveur	Rigaud neuveu du précédent
John MacWhinnie	Vansomer John
a. v. willmanns	amalie wilmans
Metsys Quinten le jeune	Quinten II Massys
Priechenfried Heinrich	Priechenfried A.
Charles Western	Hamilton Charles William De
K. L. J. Rosenfelder	Ludwig Rosenfelder
Johanes Franciscus de Arimino	Giovanni di Francesco (1441)
Pacheco Blanco Jose Manuel	Surata Pacheco de
Muzeum Českého Granátu	Museum of the Czech Garnet
Monteyne J. B.	Monteyne
Spector Knapp & Baughman	SKB Architecture and Design
Berghe Matthias Jansz. van den	Vanden Berg of Alkmaar
Frank M. Moore	Murray Frank
Scott-Moore Elizabeth	Brier Elizabeth Miss
De' Fornari Arturo	D'Aterno Andrea
Ed Hart	Goedhart Eddy
Trimmer Henry Scott	Revd Mr Trimmer Vicarage Heston
University of Southern Switzerland	USI (Università della Svizzera italiana)
Peter Ebner	Rataitz Peter
cha Kyŏngun	Kang Hŭi-ŏn
j. montaignac paris	Isidore Montaignac
Hirtum Marianne van	Quaglio Giovanni Maria Von
Drooch slooth	cornelis drogsloot
Ishimura Akiro	Aikawa Mitsuro
Frymeier G.	Jacob Frymire
Coniquen Leoner	Lebel Antoine
De la Hirr	Lahir
John Gray	John Doyly
Florian M. A. N.	Florian Mircea
Xie Xiaode	De Hsieh Hsiao
Leloir père	A. Leloir
Picknell	W. L. Picknell
Giger-Ammann Molly	Ammann Margrit
Museum der Zeitmessung Beyer	Clock and Watch Museum Beyer Zurich
Crescentino Caselli	Smith Cabell
Mondschein F.	Mont Inc.
Monogrammist P. C. H.	Monogrammist PCH
Karl II Duke of Brunswick-Lüneburg-Wolfenbüttel	Prinz Karl Friedrich August Wilhelm
Austrian Gallery Belvedere	Belvedere Vienna
Beady-thyrsus Group	Groupe du Thyrse Perlé
NMBW Architecture Studio	Neustupny McLean Bertram Wilson
k. langhammer	carl langhammer
Langhammer Carl	k. langhammer
Ernst Fuchs	Feuerfuchs
Jan Mattens	Anton Jandl
Fenyő Andor	Fenyő Ármin
François Lauret	James Laurace
Devaux Evelyne (ps.)	Axell Evelyne
M. Tocqué	Tocqué Louis
Guerard B. D.	Guérard Bernhard Von
Petrini Giuseppe Antonio	Cavalier Petrini
Robin Louise (maiden name)	Louise Adélaide Desnos
Jack B. Yeats	Yeats John Butler
Cour d'Or Museums	Musées de Metz
Bragg Steven William	Billy Bragg
Nappelʹbaum Moiseĭ Solomonovich	Nappelʹbaum M. S.
G. F. Watts	George Frederic Watts
Frelinghuysen Estelle Condit	Frelinghuysen Suzy
M. Echard	Charles Echard
Brande Henri van den	Vandenbrande pretre
j.t. soby	Thrall Soby James
Erri	del R
Herman Dirk Van Armando	Dodeweerd H. D. van
William Channing Whitney	Whitney W. C.
J. G. Meltzer	Melzer Johann Gottlieb
Alfred the Great of Wessex	Aelfred King of England
Ippolito Scarsella Ferrarese	Scarjenu da ferrara
Istituto di storia dell'arte	Florence. Kunsthistorisches Institut
Musée de l'Avranchin	Musée in Hôtel de Ville
Gadiot Phonse	Daalen Phonse van
f.a. schmidt	Friedrich Albert Schmidt
J.B.M. Pierre Ecuyer premier Peintre du Roi	pierre j. b. m.
Francis Rowland Yerbury	Yerbury F. R.
Dewey c.m.	Dewey Charles Melville
Hill Anthony	Redo Achill
heinrich friedrich laurin	Laurin H. F.
hao Chengju Gukuang Chingxia tingzhang	Tu Chin
Beyeren Abraham Van	Albert Beijren
Augustus imperatore romano	Gaius Julius Caesar Octavianus Augustus
Subramanyan Kalpathi Ganapathi	K. G. Subramanyan
Son Ford Thomas	Thomas James Henry
Augustinus de Florentia	Agostino di Duccio?
Gothardt Mathis	Grunewald Neithardt
Giovanni Da Rimini	Johanes Franciscus de Arimino
prof. fritz baer	Baer Friedrich August
Haagmans Alphons Jozef Hubertus	Fons Haagmans
Seitter Joseph Daniel	Daniele il Cavaliere
Monsu Cristiano	Christian Berentz
Monogrammist G.V.L.	G. v. L.
Alexander Rainy	Yalkut Howard Alexander
Salomé Wolfgang Ludwig	Wolfgang Cilarz
Canziani Louisa	Starr Louise
Vespesiano Emperor of Rome	Vespasian Römisches Reich Kaiser
Jack Tilton	Tilton John Havemeyer Jr.
Jonsson Sven	Markelius Sven Gottfrid
Carmelo Arden Quin	Alves Oyarzum Carmelo (birth name)
J.B. Kidd	Joseph Bartholomew Kidd
Borcht Peeter van der (I)	Verborcht Pierre
Carl Engel	Rabenau Engel von der
Rodríguez Hernández Antonio	Antonio Julio
Koller Johann Caspar	J.C. Koller
B. Engelz.	Engelsen Bartholomeus
Tchernykhov Jacob	Černihov Jakov Georgievič
Thomond Mary	Palmer Miss Mary
Tuby Jean Baptiste (I)	Jean Tuby the Elder
Le Jean	Jean-Pierre Quenson
Elizabeth Welles Perkins	Perkins E. W. Miss
Bouche-Villeneuve Christian François	Marker Chris
H. E. Hartolt	Thieriot Charles H.
Picknell William Lamb Lucien	W. L. Picknell
Crawford David Alexander Robert Lindsay Earl of	Balcarres 11th Earl of
Camps J. M.	Camps Arnau José María
Leroy Elisa	Desrivières Élisa
Hampoole Richard de	Eremita Richardus
monogrammist H. L.	bez. H. L.
Itsuko Hasegawa Atelier	Hasegawa Architect and Associates
Ding Xiongquan	Ting Wallase
C. V. M.	Monogrammist C.V.M.
Luis Siciliano	Luigi Rodriguez
Seconda Università degli studi di Roma	University of Rome Tor Vergata
Jack Taylor	John Williams Taylor
Lucatelli Giovanni Francesco	J.-F. Lucatelli
Adalbert Prince of Prussia	Adalbert (Prinz von Preußen)
Reysschoot Pieter Jan van	Petrus Johannes de Engelsen
Barraud François	Gustave Francois
Purcell Chas. Corbutt'	Young Corbutt
Xu Yuren	Hsu Yu-jen
Yoly Gerardo	Yoli Villa-Mario Gabriel
John Joseph of the Cross Saint	Croce Giovan Giuseppe della Saint
Master of the Coronation of the Virgin	Maestro dell' Incoronazione
Martínez Fray José	Martínez Gerónimo Jusepe Batista
Jackson (Dublin)	Jackson
Oliver W. Marble	Aldrich Nelson W.
Iacinto	Giac.to Ci[mi]gnani
Park Soo Keun	Pak Su-gŭn
Johnpaul Jones	June John
Mokhtar Gamal	Mukhtār Muḥammad Jamāl al-Dīn
Pudlat Ningeoseak	Pudlat
Finkelstein Peter Max	Max Peter
Thomas Jones Barker	Janice Oresman
Pío del Valle y Fernández Evaristo Antonio Víctor Pelayo	Pío del Valle y Fernández Evaristo Antonio Víctor
Ragacini	Ragazini (unidentified)
Bremer Anne	Bremer
Jack Roth	Roth James Buford
Dujardin J.	J. Labrador
anonymous Cilician	unknown Cilician
Evert van Heerden	Gerrie van Apeldoorn
Hanke Stefan	Han Si-gak
Lauwick	Lauwick Alexandre
Huysmans P.J.	P. Huysmans de Bruxelles
Math. Lempertz	Kunsthaus Lempertz
Jou Francisco Pedro	Jou Pere
H. Tischbein jun.	Johann Heinrich II Tischbein
Nha Hau Ly	Later Ly dynasty
Rincón	Rincón Antonio del
Cluser Hettore	Deckers Theo
Frost Terry	Frost Terence Ernest Manitou
unknown Québecois	anonymous Québecois
Dufay Alexandre	Henry Alexander
Kern	Kern Johann Adam
Wenzel Anton Fürst von Kaunitz-Rietberg	Kounic-Rietberku Václav Antonín z kníže
Alois Carigiet	Li Ai
Mariano d'Antonio di Francesco Nutolo	Stagnon Antonio Maria
McCaw Terence	Targone Cesare
Collignon Jean Baptiste	Colignon François
M Sirr	Sirr Henry Charles Major
Varen︠t︡sov Mikhail Petrovich	Korinfsky Mikhail
H Wright	Harriet Wright Miss
Casteren Han van	Baelen Jacobus van
Johann Christian	Christian Sottile
James Campbell	Bep Amesz
Duball (unidentified)	Du Ball
Biederbick Christa	Dürr Horst
Ira Cassidy	Fioravanti Cosimo
Henriette	Moscozo Flore Célestine Thérèse Henriette Tristan
Lewis John Frederick	Lewis J. F.
Polk Brigit	Berlin Brigid
Betsy Davis	Visscher Beernt De
Capia Jean	Garcia Peña
Daura Pere	Daura y García Pedro Francisco
Zick	Zick Alexander
Overbeck	Friedrich Overbeck
Poost	Post (unidentified)
Suicide Alan	Bermovwitz Boruch Alan
Voulk Douglass	Stephen Arnold Douglas Volk
S. Jones	S. (Dublin) Jones
Delalleau André	Andreev Ivan
unknown Birnick	anonymous Birnick
Pietro del Pietre	Pietro Antonio de Pietri scolare di Carlo Maratta
Monogrammist R.H.	R. H.
Schryver te Brugge	Deschryver
Johnson Stanley	Johanna Weil
Lauterer	Johann Franz Nepomuk Lauterer
Deveit	Deweth disciple de Rembrandt
Ld Ravensworth	Liddell Henry 1st Baron Ravensworth
Antonio Cassi Ramelli	Casamor de Espona Antoni
Abas Felipe	Abeilard Pierre
Elmereat	Emmelraet Philips Augustyn
Mazois F.	Mazois Charles François
Frignano Group	Dolphin Group
Van der Horst	Horst
Seres	Serres family
Holländer Jan	Verelt Jan Willekens van
Taravalle	Taraval Hughes
Zucerelli	Zuccarlli Franco
Hassam Chide	Hassam
Foster Evelyn	Evelyn Antal
Wennerwald Emil	Wennerwald Emil August Theodor
Yáñez de Santa Cruz Marta	Mata Duque Juan de la
Halima Nalecz	Krzywicz-Nowohonska Halima Maria
Saranyena Juan	Jan Soreau
L'Ammogliato Mariotto di Zanobi Folfi	Folfi Zanobi
Howland Hortense	Delaroche-Laperrière Louise-Marie Hortense
schluter	August Schlüter
Wüst Caspar	Wust
Howard Snoweiss Design Group	Groupe de Lagioia
Gessner Hubert	Dieter Ebert
Michele da Pavia	Michelino de' Molinari da Besozzo
Andrea Casalini	Pozzi Andrea
Antonio Tempesta Fiorentino	Tempesta
Eolli	Joli Antonio
Sebron	Sebron Hippolyte Victor
Camu Carl	conzalvo carelli
Taillasson	J. Jos. Taillasson
unknown Tibetan	anonymous Tibetan
Lemos Carlos	Ceres Rubio Daniel Carlos
Edward Newell	Groder Edward Thomas
Van Ryhn	Ryhn Van (unidentified)
Markiewicz Kasimir Dunin	Markiewicz
J. -C. Chardon	Chardon Jean-Claude
Planet Marie Francois Xavier Louis De	Planet Louis
Dyk Philip van	P. Van Dyke
Nanni Giovanni di Bartolo il Rosso	Rosso Il
Azoldt Johann	Bartolo Giovanni
Greef Jean de	Greef Jan de (1784-1834)
Mindspace Architects	Mindspace
Zugel Wilhelm	Zugel
YouthBuild	Youth Build
Berthold Segal	Baechler Donald
OConnor	O'Connor (Dublin)
Mathias Goeritz	marian Hendrie
augustin	Augustin J-B.-J.
Sacriste Eduardo	Jonas Edouard Mrs.
Marcelo Moscheta	Michael Scholz
J. Jundt	Jundt Gustave-Adolphe
girier	Cyr Jean Aimee Girier
Master Of Alkmaar	Master of the Seven Works of Mercy
Maykel	Maijkel David
Marvin Rhodes	Thomas Germain
William Elford	Elford Baronet
Barkan Mirit	Giorgio Garau
Rothe	Rothe Friederik W.
Wood Grant Devolson	Grant Wood
Esslingenn Hannss von	Hans Böblinger II
Effert Martin	Perrot Antoine Marie
Hogenbergh Franz	Hogenbergus Franciscus approximately 1539-1590
Anna Daun	Jane Anderson
Galka Scheyer	Scheyer Emilie Ester
Stephan Haweis c/o Mus. Modern Art	Stephen George Haweis
Merck Van Der (unidentified)	J.C. Fr. (unidentified)
Motezuma	Montezuma I Emperor of Mexico
Hooghe	Hooge Romeyn de
Felice Riccio	Felice Brusasorci
Lisitsky Lazar Markovich	Lisitsḳi Eliʻezer
Paillet Charles	Paliez
v Meulen Dordt	Vermeulen
Bayard Emile Antoine	E. Bayard
Samuel Vaucher	Vaucher Jean Marc S.
George Balthazar Gardner	Gardner G. B.
Karl Waage	Wang Sam
Luscombe Ketland	Luscombe
Couzijn Lies	Cosijn Alida
George Allen	Ottinger George Martin
Uranga Pablo	Díaz de Arcaya Pablo Uranga
Zehender	Zehnter Johann Caspar
Johann Caspar Zehender	Zehender
Copley John	John Berry
Etungate Abraham	Etungat
Charles Gavard	Gavard Jacques
Satish Sharma	Williams Sarah
Nebbia	Nebula Cesare
Ernst Zinsser	Menachem (Ernst) Buchbinder
Gutierrez Mauer Andrés	Gautier Albert Clément Valéry
Giovanni Marco	Pitteri Marco Alvise
Moorsel Marijke van	Asperslag Marijke
Nadorp F.	Nadorp Franz Johann Heinrich
Vitra GmbH	Vitra
Schrotter Bernhard Edler von	Fouchier Bernard
Pasquale	Genovese Pasquale
Alexandra Grigorovich	Hryhorovyc Oleksandra Oleksandrivna
Montenbrock (unidentified)	Montenbtock
VanDerBeek Stan	Beek Stan van der
Pirchan Emil der Jüngere	Emil Pirchan
Maggieri Cesare	Valencia César
Hautreu (unidentified)	Kautreu
Boardman Harriet	Bandera Maria Cristina
Reesbroeck Jacob Van	Reesbroeck
Lesquier	Lesquier Joseph
Portien ? (unidentified)	Portien
Gerard Manley Hopkins	Mlle Garnier
Plasent Gomez (unidentified)	Gomez Plasent
Langdon Alvin Coburn	Coburn A. L.
Jehan Duvivier	Hennequin du Vivier
Du Vivier Hennequin	Jehan Duvivier
Ramond Torres Spanish	Solà Ramon the younger
W. Scott & Sons	Sons
Krauss Helene Von	Krausz Baronin
Champney	Benjamin Champney
Taunay Nicolas-Antoine	Taunay
Currado	Cavalier Curradi
Scott Lady	Caroline Lucy Scott
Musée du Québec	Musée national des beaux-arts du Québec
Savelli Sperandio	Sperandio di Bartolommeo de' Savelli
Giuliana Cunéaz	Giuliano Tallarini
Westphalen (Hamburg)	Westphalen
Laurent Veuve	Clare Devine
professor jacobides	Iacobides Giorgios
Fabri Luigi b. ca. 1778	Fabri Aloisio approximately 1778-1835
Paget Henry Marriott	Paget H. M.
Erb Simon	Smits Simon Hendrikus Cornelis
Hon. Admiral Finch	Honorable William Clement Finch
maO studio d'architettura	MaO
Charlemagne-Baudet Joseph	Iosif Adolfovich Charlemagne
Ulrich Mack	Mack Ulrich Bernhard Gerhard Antonius
louis piot	Piot
Guyon Goepp	Maximilienne Guyon
Wade George	Field-Marshall Wade
Pomeroy James Calwell	Jim Pomeroy
unknown Colima	anonymous Colima
Guillén Josep Simont	Simont J.
Solomans Estella Frances	Solomons Starkey
Estella Frances Solomons	Solomons Starkey
Claus Wilfried	Camus Claude
Sirrani	Sirani (unidentified)
Gruppo a Maschere Umana	Face-Mug Group
James Wilson	Wilson Associates
Magistris Simone	Simone De Magistris Da Caldarola
Tantong Van (unidentified)	Tantong
Tangten	Tantong Van (unidentified)
Ewing Charles Kermit	Ewing Buck
Pittar	Pittar J.F. Barry
Strecker rue des Billettes	Streicker
Bray and Warren	Bray
Sjaak Korsten	Korsten Jacobus Wilhelmus Maria
Werkmeister Matthew (unidentified)	Moré Thomas (unidentified)
Henri VI empereur germanique	Henry VI King of the Germans
Ignashina E. V.	Ignashina Elena Vladimirovna
Baldornero Galofre	Bald. Galofré y Giménez
Charle Albert Joseph	Alers Theo
Goicouria Peter A.	Keller Arthur A.
Frédéric Sorrieu	Sorieut
P.H. Rogers	Philip Hutchings Rogers
Fraunhofer-Society	Fraunhofer-Gesellschaft zur Förderung der Angewandten Forschung
Philodemus of Gadara	Philodem
Langlois Vincent Marie	Langlois le jeune
Jünger F. G.	Jünger Friedrich Georg
Yarnell Associates	Martinelli Andrea
Bartolomeo Guidobono	Guidobono Il Prete Savonese
Carlos Seoane	Craig James Osborne
Leonard John Henry	John J. Emery
Friedmann Cornell	Carl Ferdinand Stelzner
Moreth J. (unidentified)	Morethet
Rozenberg	Rosenberg Friedrich
Charles-Louis Constant	Elants Cornelis
kane paul	Kane John
Manuel de Ron	Louis de Narbonne
Petrus Plancius	Plancio
Odato Christian	Richardson Christopher
Lauber Marcelo	Michel Brante
Malu Fatorelli	Karl Marx
Pizarro Maria Jose	Papi Domenico Maria
Johann Jakob Biedermann	Anonym. Vermutlich Biedermann
barthel bruyn D. A.	Bruin Bartold
Checcho di Michelangelo	Del Caravaggio Cecco
Todd	Todd Richard
Noni Lichtveld	Lichtveld Maria Johanna Francisca Renée (Noni)
T. C. Hine	Hine Thomas Chambers
Georges Edouard François	Georges E. F.
Marichal Carlos	Paillot Marc
Ermanno De Berardis	Medina Juan de
Adriaenssens Jan	Juan De Tejerina
Ernst Ferdinand Oehme	Oehme E. F.
Andrea Ricci	Andreas Igel
Gabriel Jaime Giraldo	Jaime Durán Castellanas
Ordway	Alfred Ordway
Belkyn Cornelis	Bellequin
Benedetto di Bartolomeo de' Grazini	Grazzini Benedetto
Ghirlandajo Ridolfo di Domenico	Ghirlandaio Bigordi
Christoph Sattler	Huët Christophe
François Deron	Raz Gideon
Arnold John	John Randall Bratby
Knight	Edward Knight
anonymous Gieli	unknown Gieli
Öffentliche Kunstsammlung Basel	Kunstmuseum
Hulse Edward Sir 3rd Bart.	Sr E Hulse
Woodbridge Jonathan Edwards	Rothfarb Edward Leland
Fischer Ellen	Charles Fisher
Sori	Pierre Sorri
Monsù Peti	Alexander Petit
Schiedges	Schiedges Petrus Paulus
Storck Jacobus	Storck
Altdorffer Erhard	EA Master
Gibson Peter	Gibson Robin
Monogrammist IS	Monogrammist I.S. (active 1632-1658)
Vigne Edouard de	Devigne
Beaurain Philippe-Joseph	Philipp Sauerland
Glueckselig Friedrich	Bergammer Friedrich
verbruggen	Verbrugghen Henricus-Franciscus
Venice. Galleria di Architettura della Fondazione A. Masieri	Galleria Masieri
Bola F. (unidentified)	F. Bola
Trent William Edward	Trent W. E.
Jacob Heusch	J. de Heus
Carpanetti Arnaldo	Carola Dertnig
Saintpierre Gaston Casimir	Saint Pierre
Ubaldini Domenico	Domenico di Bartolommeo
David I roi d'Ecosse	David I King of Scotland
John N. Holden	John Grüniger
Grüniger John	John Collet
Ampurias Master	Master of Castelló d'Empúries
Brisschauw	Brasjauw Melsen
Stanley 1st Lord Stanley Of Alderley	John Thomas Stanley
Valke	Johannes von Valkenburg
Leven A. (unidentified)	A. Leven
Brunet J. (unidentified)	Brunet Jean Jacques Baptiste
Janssens (Gent)	Janssens
Reusch (Amsterdam)	Reusch
Scanes Mrs. Maude	Maude Goodman
Jensen I.L.	Jensen Johan Laurits
De Vuet	Arnold de Vues
Osler Viktor Emanuel	osler
Peter Haag	Haag Peter (unidentified)
Arnold Reinthaler	François Peintre à Bruxelles
Offiener	Allemand Offienier
Chinzei	anonymous Chinzei
Petrie William Joseph	Petrie Bill
Domenico Mioni	Domenico di Candido da Tolmezzo
Komatsu/Rangel	Komatsu Architecture
Kunstcentrum de Singel	Singel
Wolkonsky Maria Princess	Volkonskai︠a︡ Marii︠a︡ Nikolaevna kni︠a︡gini︠a︡
Dub...	Dub (unidentified)
Mijn Gerard van der	Daniel Van Beke
Mackey (Dublin)	Macky
Kruse Alexander Zerdini	Kruse
Alexander Zerdin Kruse	Kruse
Geneviève Delaunay	Abbé-Decarroux Geneviève Delaunay-‏
Le Brun	Lebrun d'Anvers
Jan van Ruysbroeck	van den Berghe Jan
Gerrit Alberts	Servaes Albert
Hausmann Elias Gottlob	Charles Gottleib Lang
Robinson George Thomas	Thomas Keene
Gilly de Montaut Wilhelm	Gilly Wilhelm
S. Vogelaer	Vogelaer S. (unidentified)
Ruggeri Ferdinando	Ruggieri
Griswold David J.	Hurn David
H. Kock	Kock H. (unidentified)
Norman I Wilkinson	Wilkinson
Camarón y Navarro María de la Asunción Elena	Elena Camarón
Innocenz Tacconi Schüler von Carraccio	Tacconi
Mariano da Radicofani	Mariano De'Vecchi
Khatir Reza	Reza
anonymous Tonocoté	Tonocoté
Fuenes Gabriel	Garcia Fernandes
Nuvolone Giuseppe Panfilo	Panfilo Il
Kristina Ford	Ord William
Architectenbureau ZZ&P	ZZ&P
Bonhams	Bonham's Auction House
P. Venodar	Venodar P. (unidentified)
Poppi	Poppi fiorentino
James Hadley	Charles Servais
Tischbein family	Thisbeyn
Borcht Peter van der II	Verborcht Pierre
Innocent Charles John	Charlotte Lancelot
Nicolaï Jacques	Jacquinot
de Langh	delachaux l.
Neuhaus	Fritz Neuhaus
Neuhaus Karl August Friedrich	Neuhaus
Gilarte Francisco	Gilarte Matheo
Wolf	Wolf F.
Edith Ellenborough	Edith Corbet
Marchart Alexander	Alex Sweetman
Gemarius de Kepper Peter	St. Germain Jean-Joseph de
Albeslo Bernard Willem	Gale William
Albeslo B.W.	W. Gale
Reinhoud	Reinhoud D'Haese
van Hage (unidentified)	Van Hage
Richard Burden	Brams Richard
Morone Giambattista	Moroni
Feindt (Hamburg)	Feind
Hammershoi Ida	Ida Ilsted
Buck William	William Raeuber
Schompt (unidentified)	Schompt Hollandois
Giulio Todeschini	Motta Giulio
Frans Claessens	Clausen Franciska
Torretta Giovanni	Tortona Antonio
Kibrik Evgenij Adol'fovič	Yevgeny Kibrik
Fitch Captain	Fitch Simon
Lawrenson	Lawranson (unidentified)
Lopez Vicente (unidentified)	Lopez Vicente y Portana
la roche noire	Charles Julien de La Rochenoire
Eisen Anton Paul	Antonenko Evgeny
Gibbs Henry Hucks 1st Baron Aldenham	Gibbs Henry II
Kopps	Kops Jean-Baptiste Charles
La Joue Jacques de	La Joue
Clarence Sumner Luce	Sumner Maud Frances Eyston
Norice	Norris (unidentified)
Lemieux	Ludger et Paul-M. Lemieux
ICOMOS France	Section française de l'ICOMOS
Guillaume de Kempeneere	Kempenaer Willem I
Urania Free Learning Institute	Freies Bildungsinstitut
Marie-Claire Waille	La Rochefoucauld Marie-Christine
Pietro Marubi	Peter Hav
Ferdinando (unidentified)	Ferdinando pittore del Re di Polonia
Fox (Dublin)	Fox
Pine John	Donald John
F*** J. (unidentified)	J.F***
Chermaev Serge	Chevska Maria
anonymous Páez	Páez
Gooch (Mount St.)	Gooch
Millais Lady	Lady Euphemia Chalmers Gray Millais
laurent	Jean Antoine Laurent The Elder
Hannah Brown Skeele	Skeele Harriet B.
Rowhn P. (unidentified)	P. Rowhn
Adler Friedrich	Frédéric Dedelley
unknown Scottish	anonymous Scottish
Georg Arnold	Bendl Johann Georg
Peretti	Perotti Pietro Antonio
Sr H Mann	Horace Mann 2nd Baronet
van Vucht	Vucht
Arniches Carlos	Jan Arons
Soucaret Dhainaut Mme. M.	mme soucaret
Town	Town Francis
Gericke Samuel Theodor	Geraci Paolo
Roerbye Wedseltoft	Rørbye Martinus Christian Wedelstoft
Guggenbichler Meinrad	French Leonard
Abraham Ragueneau	Ragueneau
Wallace Gallery	Wallace Gallery of Decorative Arts
Page	John Page
Steuart Charles	Stuart Charles (active 1762-1790)
Alfred Diethe	Diethe
Rutter	Carl Ruthards
Grünwald Alfred (1891-1927)	Gruenwald Alfred Emanuel Ferdinand
Robert Macdonald Fraser	Robert Arthur
Howard Wilh. Rudolf Hermann	Howard Will
Monogrammist P.V.S.	P.V.S.
Drost	Anthonie Drost
Jordan Judah	Yordan Yehudah
Vandrebanc John	Banck Jan van der
Cowherd Barney	Cowherd Elwood Martin
Blakey Nicholas	Baker Charlotte
S. Loren	Loren S. (unidentified)
Mariano Vasi	Stig Martine
Martine Stig	Mary Smart
Caiserman Ghitta	Chase Sara
B. Engels	Engelsen Bartholomeus
Louis Dubois	Dubois Ludovicus Joannes Baptista
Plaas	Plas Van Der
Van Der Plas	Plaas
Jorge Vall	Dort Willem van
Reza	Riza Abbasi
Klimt Gustave	Klimt
Parkstraatkerk (Hague Netherlands)	Heilige Jacobus de Meerdere (Church : Hague Netherlands)
nigg	josef nigg
Nigg Joseph	nigg
Kunst- und Auktionshaus Gindele	Gindele
M. Jean Soul	Soul Jean (unidentified)
A. Limburg	Limburg A. (unidentified)
Wouter Schram	Schram Wouter Jorinus Bernardus Anthonius
unknown Swat	anonymous Swat
Ed Emsh	Emsler
Keuin Hendrik	Kuhn
Jiroudek František	Rivet Francesco
Ramírez Cristóbal	Christina Fernandez
Morlon Antoine	Morlon
Donato called Donatello	Betto Bardi Donato di Niccolò di
Souza Osmar Pinheiro de Jr.	De Perlinghi Jerôme
Seve Pierre	Pierre de Sève le Jeune
Robert Glaus	Moore Gilbert
Gianni Gamberini	Maria Gioia Tavoni
unknown Gilbertine	anonymous Gilbertine
Honich Adriaen	Honich Lossenbruy
Planungsgruppe HASS Freiraum und Landschaft	HASS
Roberto Parysow	Robertson John Ewart
van Nes	Kanō Heishirō
Zoon	Scholtens & Zoon
William Brown (Firm)	Brown (Firm : Edinburgh Scotland)
Francesco da Volterra	Capriani Francesco
Hisashi Tenmyouya	Tenmyouya Tenmyōya
Ladovskiĭ N.	Ladovsky Nikolay Aleksandrovich
Mizer Bob	Mizer Robert Henry
Andrew Walter	André Hebuterne
Jean Laurent Legeay	Le Geay Architecte
Marcy Rosenblat	Rosenblum Richard
Madrazo Fréderic Carlos	Madrazo y Ochoa Federico de
Whalley Andrew	Nash Andrew
Wyon Thomas	Wyon Thomas the elder
Yaqub Sanu	Ṣannūʻ Yaʻqūb ibn Rāfāʼīl
Pascoe Martin	Peredes Mario
Henrique Pousão	Henriques Cesar De Araujo Pousao
Gustav Wilda	Wilda Gottfried Heinrich
Baron Leighton	Lord Leighton Frederic Leighton
Hacker	Hacker (Frankfurt)
Gillian Barlow	William Raddon
La Rue	M. de la Rue
Niedmann August Heinrich	Augustin Handzel
Turner William II	william herbert Dunton
Tsjaikov Josef	Iosif Chaykov
Oliver Kruse	John Oliver
Daniel Martinez	Verstappen Martin
Steele T. C.	Theodore Clement Steele
Achille De Dominicis	Depey Johann De
Angrand Charles Théophile	Charles James Adams
Mallais	Mallet Jean-Baptiste
Boston Painter	Pittore di Boston 397
Claire Spicer	Vasile Cercel
Johann Hinrich Quinckhard	Quinckhardt
Ricci Francisco	De Guevara Francisco Rizi
Michal Hefer	Michael Bornschlegel
Agus	Agasse Jacques Laurent
Muskett	Muskett (Norwich)
Peerdt Ernst Carl Friedrich De	e. de. peerdt
Lotte Errell	Sostmann Lotte
N. Rombaut	N. Rombaut d'Alcmar (unidentified)
Charles Voillemot	Voillement
Williamson (Dublin)	Williamson
Posenaer Jos	Jozef Karel Frans Posenaer
David Ryackaer	Rykars
Wilhelm von Beyer	Beyer Christoph Friedrich Wilhelm
Wellesley Sir Victor Alexander Augustus Henry	Victor Wellesley
Stefan Maria Heizinger	Egan Moira
Chevalier Pauline	Caroline Louise Martin
Simon Maria	Wasserman Simon
Core Philip	Lasser Phillipe
b. ives	Brayton C. Ives
B. Yves	Brayton C. Ives
Molani	Aureliano Milani Bolognese
Flaviens C. Chusseau	C. Healey
Miel Francis	Vernay Miel
Sedefkâr	Sedefkar Mehmed Agha Biçakçiu
L. K.	Deutscher Monogrammist L. K.
Mann	Jan de Mann
Peter Rysbraeck	Risbrach
Pandolfo Reschi	Monsù Pandolfo
Godebska Misia	Natanson Misia
S. Kuyp	Cuyp S. (unidentified)
unknown Gurunsi	anonymous Gurunsi
Fisher	Messrs. Wells and Fisher
Burrard Harry Sir	Harry 1st Baronet Burrard
Cavendish-Bentick William Henry	Bentinck William Henry Cavendish Cavendish- third duke of Portland
P.F. Storgue.	Storck P.F. (unidentified)
Johann de Hemsen	Hernesen
schneider	Schneider Johann Kaspar
Ted Shawn	Shawn Edwin Myers
Pieter Mulier d.J. Genannt Tempesta	Pietro Tempesta
Wm. Atkinson	[William Atkinson]
T.J. Blakeslee 358 fifth ave.	t.J. blakeslee
Blakeslee T.J.	T.J. Blakeslee 358 fifth ave.
Gherardo Mechini	Gerard
Technische Hochschule Wien	Polytechnisches Institut
Monogrammist O.M.E.	O.M.E.
Charles White	Guidetti Carlo
Frederick I	Friedrich I Barbarossa imperatore del Sacro romano impero
Nicholson Dana	Dana Lixenberg
U.K. Architects Against Apartheid	U.K.A.A.A.
Morel Vaarzon Morel	Vaarzon Morel Willem F. A. I.
Tucker Albert Lee	Tucker
Jean de Carondelet	Aragon Juan de
ESB International Building Consultancy Group	ESB
Schwartz	Fishel Adler & Schwartz Gallery
Prieur Mathieu	Hubert Pierre Alain
Carl Heinrich (I) Hoff	professor carl hoff
Birgit Antoni	Charlton Annie
Aivazovsky	Ajvazovskij Ivan Kostantinovic
Nicola Moietta	Moietta da Caravaggio Nicola
Jacobson Arthur	Arhiv Tošo Dabac
Czartoryska Maria Zofia księżna	Denhofowa Marja Zofja
Diebitsch Charles de	Diebitsch Carl Wilhelm Valentin von
Yon	Edmond Charles Yon
Berry Judith	Beyer Gerd
Falcao Trigoso	Falcão Trigoso João Maria de Jesus de Mello
Grimshaw Architects	Grimshaw
Pietersz Aert	Pierre Cardin
Passij	Passy Joannes Baptista
Thos Agnew & Sons London	Thomas Agnew
Volcker Otto Hermann Emil	Otto Volcker
Aligny Claude-Félix-Théodore Caruelle d'	Aligny
Fabrique	Fabrique atelier d'architecture
Ake J. David	Davis Kelly A.
Hans Seiler	Sharon Shein
Evart Charles Joseph Frederick	Laurence Frederick Sturgis
Scheib	Scheib Christian Friedrich
César Pattein	Martin (Paris)
Kane Robert	Kane Bob
Antonini Andrea	Douglas Andrew
Csáky Joseph	Csaky Jozsef Alexandre
Harvey	Harvey George II
Voort van der	Eugene van Verboeckhoven
franz anton winter	Eigentler Franz
Luna	Luna family
Ding Nanyu	zi Nanyu
benjamin herring	herring
Maler	Maler Hans
Andrea Carlson	Gabriel Salmon
David Bowie	Jones Davy
Robert Grange	Ganter Bernard
Cambi casa d'aste	Cambi (Firm)
Marco Sanmartin	Marcello Pietrantoni
Schommer	Schommer François
Schimt	Jean Joseph Schmit
Lüdeck	Ludeck Lodewijk van
Muzej savremene umetnosti (Skopje North Macedonia)	Museum of Contemporary Art Skopje
Yriarte Ignacio	Iriarte
De Iriarte Ignacio	Iriarte
Charles Édouard Haviland	Hibbard Charles P.
Jan H. B. Koekkoek	Koekkoek Johannes Hermananus Berend
Vasari Lazzaro ca. 1399-1468	Lazzaro Vasari
Batyo (unidentified)	Batso
Martí Ramon	Jrma Bamert
Carlos Oyarzún	Dan Clowes
Fraxinetus Alfonso [Unidentifed]	Fraxinetus A.
Klah-tso	Hosteen Klah
Schmidt C. C. Alexander	Schmidt Alexander (1842-1903)
Gensfleisch zur Laden Johann	Gutenberg Johannes
Melchers	Melchers Julius Gari
Garrett Smith	Hanna Gartner
Adamo Claudio	Alisa Braudo
Mattens Jan	Jantl Anton
Denison J.M.	Mellot Denise
Biedermann Josef	Dan Beudean
Croos W. (unidentified)	W. Kroos
Josef Eberl	Joseph Heard
Brooklyn Museum The	the brooklyn institute of art & science
Ja`far ibn `Alī al-Tabrīzī al-Baysunghurī	Baysunghuri Ja'far
Bob Davis	Davis Robert James
Donald Blair	Clayton Donald Francis
Austin Harrelson	Eldar Sharon
Duward Salomon	Duarte Salomon active 17th century
Fitzgerald (Dublin)	Fitzgerald
Assteyn Bartholomeus Abrahamsz.	Van Assten
Hieronimo Genga	Genga disciple de Raphael
Gill	Gill (Dublin)
Huebner Birgit	Albert Hoflinger
Passemirs	Benoît Joseph Passeniers
Leen	Leen G. van (Guillaume)
Graf von Haack	Haack
David Magee (Firm)	David Magee Antiquarian Books
Rizi Juan	Fray Juan Andres Ricci
Elekfy Jenő	Kirchner Jenő
Giuseppe Giacomo	Giacomo Ferrari
Graft	Graft Design
H.J. Moore	Moore H.J. (unidentified)
Schäfer Karl (1821-1902)	Schäffer Carl
Soldiny	Soldini Luigi Domenico
Klauber family	Klauber
Besschaert	Ambrosius Boschart
professor a. kindler	albrecht kindler
Kindler Albert	professor a. kindler
Glycerius Emperor of Rome	Glycerius
Welser	Welser family
Luks	George Luks
Courtray	Corneille De Courtrai
Pictorius	Pictorius Johann Martin
Gutai Group	Gutai Art Association
Marasco	Antonio Marasco
Thessaloniki Cultural Centre of the Cultural Foundation of NBG	Politistiko Kentro Thessalonikēs
Harkins M. (unidentified)	M. Harkins
Carl F. Schlüter Kunst- und Auktionshaus	Schlüter Carl F.
Arkitektgruppen DIVA	DIVA
Tiberghien Petrus Franciscus	Tiberghien
Johannes Baader	Baader Alexis
Nuti Mario	Massimo Molteni
